* 1. série
** 1
patient is deceased - pacient je mrtvý
scrub - bezvýznamný člověk
insensitive - necitlivé
puke dávit
stay sane - zůstat zdravý
quickie rychlovka 
jerk záporák
it's a piece of cake - brnkačka
autopsy - pitva
dork - ňouma
I'm the man - jsem pašák

** 2
janitor správce
you tattled yesterday - žvanila jsi včera
don't rush me - nepospíchej se mnou
I reached him - dosáhl jsem toho
freckles - pihy
rash - vyrážka
ligament - šlacha

** 3
in my gut I know I'm right - ve svých útrobách vím, že mám pravdu
tag - běhat za někým

** 4
neat old lady - milá stará paní
heart beat - tep
stall - oddalování
it did not come up - nepřišla na to řeč
cherry soda - višňová sodovka
ginger lemonade - zázvorová limonáda
you made the right call - udělala jsi správné rozhodnutí

** 5
I am not flashing my brests - neodhaluji svoje prsa
cuddle - obejmout
boobs - kozy (prsa)
cheaf of medicine - primář

