* 2. série

** 1
cranky rozmrzelý
naughty bits - hambaté části
I was in this foul a mood - měla jsem tak blbou náladu
implication důsledek
highs and lows - vzestupy a pády
children's fable - dětská bajka
you're feisty - jsi divoká

** 2
tiny splinter - mrňavá tříska
cross-eyed watter snake - šilhavý vodní had
lanyard - laso
it was kind of demeaning  - bylo to trochu ponižující
dog goes winkle on the carpet - pes počůrá koberec
contempt - opovržení
underappreciated people - nejopovrhovanější lidé
misguided - zavádějící
that was lame - to bylo ubohé
it's disturbing - je zneklidňující
you are obssesed - jsi posedlý
peeps - lidičky
duck - skrč se
shut the hell up - drž už sakra hubu

** 3
hypocrisy - pokrytectví
my tummy - moje břicho
detestable suck-up - nejodpornější patolízal
sycophant - šplhoun
equipment - vybavení

** 4
equaly ennoying - stejně otravné

** 5
pins it to his lapel - připne si to na klopu
I look spiffy - vypadám super, vyjímečně ...
you're the biggest geek - jsi ten největší pošuk
it's a tie - je to remíza
it was just a fling - byla to jenom jednorázovka

